NO ./include/xpms/beton_wall.xpm
WE ./include/xpms/bild2.xpm
SO ./include/xpms/brick_wall.xpm
EA ./include/xpms/stone_wall.xpm

C 225,30,0
F 80,50,0

11111111111111111111111111111111
11111000111111111100000000000001
11110001111111111100000000000001
11100011111111111100011111110001
11000110001111111111111111110001
10000000000000011100000000000001
10000000000000000000000000000001111
11111110001111111100011111111111
11111110001111111100011111100001
11111110001111111100000000000001
11111110001111111100000000000001
1000001E111000000111011111111111
1100000111010101111100000000111
11110111 1110101 101111010001
11111111 1111111 111111111111
