NO   ./include/xpm/wood.xpm
WE            ./include/xpm/colorstone.xpm
        SO       ./include/xpm/redbrick.xpm    


      C      225,   50    , 35   
F 80,50,0

EA  ./include/xpm/bluestone.xpm

111111111111111111111111
111111000111100000000001
111110001111100000000001
111100011111100011110001
111000110001111111110001
110001110001100000000001
110000000000000000000001
110000000N00000011111111
111111110001100011110001
111111110001100000000001
111111110001100000000001
100000000000001111111111
1000    0000100000000001
111111111111000     0001
111111111111111111111111
